A - 𐔰
Ǎ - 𐕈 
Ə - 𐔶
B - 𐔱 
C - 𐕑
Ĉ - 𐕃
Ç - 𐕖 
Ç' - 𐕊 
Č - 𐕠
Ć - 𐕉 
D - 𐔳
E - 𐔴
Ĕ - 𐔶
F - 𐕔 
G - 𐔲 
Ğ - 𐕘 
H - 𐕆 
I - 𐕞 
İ - 𐔼
Ǐ - 𐔼
J - 𐔷 
Ĵ - 𐕏
K - 𐕣 
K' - 𐕄
L - 𐔾
M - 𐕌
N - 𐕎
O - 𐕒 
Ö - 𐕒 
Ŏ - 𐕒 
P - 𐕢 
P' - 𐕗
Q - 𐕇
Q' - 𐕍
R - 𐕙
S - 𐕚
Ś - 𐕝
S' - 𐕂
Ŝ -�𐕟
Ş - 𐕐
T - 𐔸
T' -𐕜
U - 𐕞
Ü - 𐕞 
Ŭ - 𐕞
V - 𐕛
X - 𐕀
Y - 𐔺
Z - 𐔵
Ź - 𐕕